NCHAX	MunicipalBond
NHMAX	MunicipalBond
SHSAX	Health
ETGLX	MidCapGrowth
BREFX	RealEstate
USTCX	Technology
BSV	BondLowRisk
VFSTX	ShortTermBond
SSTBX	ShortTermBond
FSHBX	ShortTermBond
VBISX	ShortTermBond
VSGBX	ShortTermBond
SWBDX	ShortTermBond
PRWBX	ShortTermBond
PLDDX	ShortTermBond
SHY	ShortTermBond
STADX	ShortTermBond
VFISX	ShortTermBond
IBFCX	ShortTermBond
DODIX 	IntTermBond
MGFIX	IntTermBond
BIV	IntTermBond
PRCIX	IntTermBond
VFICX	IntTermBond
VBIIX	IntTermBond
BND	IntTermBond
FBNDX	IntTermBond
VBMFX	IntTermBond
FBIDX	IntTermBond
SWLBX	IntTermBond
FGOVX	IntTermBond
HABDX	IntTermBond
PTTDX	IntTermBond
BFACX	IntTermBond
FTHRX	IntTermBond
VFITX	IntTermBond
UGSCX	IntTermBond
FSTGX	IntTermBond
SCPYX	IntTermBond
VIPSX	IntTermBond
PRRDX	IntTermBond
PGOVX	LongTermBond
VUSTX	LongTermBond
BLV	LongTermBond
VBLTX	LongTermBond
VWESX	LongTermBond
FAGIX	HighYieldJunkBond
WTLTX	HighYieldJunkBond
VWEHX	HighYieldJunkBond
PRHYX	HighYieldJunkBond
PHYDX	HighYieldJunkBond
SPHIX	HighYieldJunkBond
SHYCX	HighYieldJunkBond
AHTCX	HighYieldJunkBond
VFIIX	MortgageBondFunds
FGMNX	MortgageBondFunds
PRGMX	MortgageBondFunds
BGNMX	MortgageBondFunds
FICMX	MortgageBondFunds
LEGNX	MortgageBondFunds
DRGMX	MortgageBondFunds
SUBYX	UCBondFund
FPURX	SpComboModRisk
DODBX	SpComboModRisk
FBALX	SpComboModRisk
VALIX	SpComboModRisk
CBLCX	SpComboModRisk
USBLX	SpComboModRisk
FABCX	SpComboModRisk
PRWCX	SpComboModRisk
HADAX	SpComboModRisk
MCCPX	SpComboModRisk
VWELX	SpComboModRisk
TWBIX	SpComboModRisk
PCPCX	SpComboModRisk
BALCX	SpComboModRisk
VBINX	SpComboModRisk
SESLX	SpComboModRisk
PAXWX	SpComboModRisk
SWOBX	SpComboModRisk
IFACX	SpComboModRisk
SVBCX	SpComboModRisk
UFSGX	SpComboModRisk
JABCX	SpComboModRisk
VTHRX	SpComboModRisk
CSGCX	SpComboModRisk
VGSTX	SpComboModRisk
TRRCX	SpComboModRisk
MTRCX	SpComboModRisk
PTTRX	SpComboModRisk
MBACX	SpComboModRisk
PRBLX	SpComboModRisk
VTWNX	SpComboModRisk
VWINX	SpComboModRisk
TRRHX	SpComboModRisk
VSMGX	SpComboModRisk
FPACX	SpComboModRisk
TRPBX	SpComboModRisk
TRRBX	SpComboModRisk
VTXVX	SpComboModRisk
FFFEX	SpComboModRisk
CBACX	SpComboModRisk
TRRGX	SpComboModRisk
FFTWX	SpComboModRisk
VSCGX	SpComboModRisk
OGBCX	SpComboModRisk
TWSMX	SpComboModRisk
FASGX	SpComboModRisk
FIMRX	SpComboModRisk
VTENX	SpComboModRisk
TRRAX	SpComboModRisk
USCRX	SpComboModRisk
FCISX	SpComboModRisk
FFFDX	SpComboModRisk
PTBPX	SpComboModRisk
STLDX	SpComboModRisk
USBSX	SpComboModRisk
VASIX	SpComboModRisk
OPECX	SpComboModRisk
PRSIX	SpComboModRisk
FFVFX	SpComboModRisk
NBICX	SpComboModRisk
TRRFX	SpComboModRisk
FASMX	SpComboModRisk
VTINX	SpComboModRisk
FFFCX	SpComboModRisk
ISOAX	SpComboModRisk
STLCX	SpComboModRisk
TWSCX	SpComboModRisk
DILHX	SpComboModRisk
OCGCX	SpComboModRisk
TRRIX	SpComboModRisk
FTMTX	SpComboModRisk
SWBGX	SpComboModRisk
NIICX	SpComboModRisk
FFFVX	SpComboModRisk
DIIHX	SpComboModRisk
STHRX	SpComboModRisk
SWCGX	SpComboModRisk
STLAX	SpComboModRisk
FTCCX	SpComboModRisk
FFFAX	SpComboModRisk
FCMRX	SpComboModRisk
STTRX	SpComboModRisk
BERIX	SpComboModRisk
MACVX	SpComboModRisk
NCDMX	SpComboModRisk
NCDCX	SpComboModRisk
AIGMX	SpComboModRisk
AGGGX	SpComboModRisk
SMILX	SpComboModRisk
NDCCX	SpComboModRisk
ABAFX	SpComboModRisk
STNRX	SpComboModRisk
STWRX	SpComboModRisk
TCGAX	SpComboModRisk
FSRRX	SpComboModRisk
PRPFX	SpComboModRisk
HSIEX	SpComboModRisk
FSDIX	SpComboAggrRisk
ACERX	SpComboAggrRisk
VTIVX	SpComboAggrRisk
VFIFX	SpComboAggrRisk
VFFVX	SpComboAggrRisk
VFORX	SpComboAggrRisk
VTTHX	SpComboAggrRisk
FCVSX	SpComboAggrRisk
GCBLX	SpComboAggrRisk
VASGX	SpComboAggrRisk
TRRDX	SpComboAggrRisk
TRSGX	SpComboAggrRisk
TRRKX	SpComboAggrRisk
TRRJX	SpComboAggrRisk
FFFHX	SpComboAggrRisk
FFFGX	SpComboAggrRisk
FFFFX	SpComboAggrRisk
FFTHX	SpComboAggrRisk
IBNCX	SpComboAggrRisk
FAMRX	SpComboAggrRisk
EXHAX	SpComboAggrRisk
TWSAX	SpComboAggrRisk
STLEX	SpComboAggrRisk
OAKBX	SpComboAggrRisk
LOMMX	SpComboAggrRisk
FTGTX	SpComboAggrRisk
FFACX	SpComboAggrRisk
SWHGX	SpComboAggrRisk
STRFX	SpComboAggrRisk
VLAAX	SpComboAggrRisk
NDMCX	SpComboAggrRisk
MCGWX	SpComboAggrRisk
VCVSX	SpComboAggrRisk
CIBCX	SpComboGlobal
MCLOX	SpComboGlobal
GIPCX	SpComboGlobal
FESGX	SpComboGlobal
LAGCX	SpComboGlobal
FGBLX	SpComboGlobal
QGRCX	SpComboGlobal
APPLX	SpComboGlobal
DODFX	Foreign
PID	Foreign
TBGVX	Foreign
SUICX	Foreign
FIVFX	Foreign
PTPPX	Foreign
AWPCX	Foreign
ICEUX	Foreign
SLSDX	Foreign
ARTIX	Foreign
WAICX	Foreign
WBIGX	Foreign
MGICX	Foreign
PCITX	Foreign
SSAIX	Foreign
HNCCX	Foreign
PRITX	Foreign
PRFEX	Foreign
AIECX	Foreign
FDIVX	Foreign
CIVVX	Foreign
PRIDX	Foreign
BJBIX	Foreign
AEPCX	Foreign
DIECX	Foreign
ARTKX	Foreign
VTRIX	Foreign
VINEX	Foreign
VFWIX	Foreign
OSMCX	Foreign
BBHEX	Foreign
VXUS	Foreign
PSILX	Foreign
MIEIX	Foreign
VGTSX	Foreign
ALGCX	Foreign
VPINX	Foreign
TRIGX	Foreign
MIQBX	Foreign
JVICX	Foreign
THGCX	Foreign
GONCX	Foreign
MCILX	Foreign
USIFX	Foreign
HIOCX	Foreign
BIIEX	Foreign
VWIGX	Foreign
LZIOX	Foreign
FADCX	Foreign
TEFTX	Foreign
DFALX	Foreign
AAIPX	Foreign
FESOX	Foreign
TWIEX	Foreign
NAWCX	Foreign
GIEZX	Foreign
FSIIX	Foreign
FFINX	Foreign
AFJDX	Foreign
MSACX	Foreign
NVICX	Foreign
DIISX	Foreign
DIVTX	Foreign
MSCI	Foreign
EFA	Foreign
FIVLX	Foreign
PIOCX	Foreign
PIGCX	Foreign
EGLBX	Foreign
FOSFX	Foreign
IBVCX	Foreign
GIEIX	Foreign
WFEFX	Foreign
FSCOX	Foreign
TFEQX	Foreign
IEGCX	Foreign
FIGRX	Foreign
DEGCX	Foreign
GCICX	Foreign
GTIIX	Foreign
MDIGX	Foreign
UMBWX	Foreign
JIECX	Foreign
JAIGX	Foreign
FAOCX	Foreign
MSILX	Foreign
LAICX	Foreign
ABICX	Foreign
MOSAX	Foreign
TWEGX	Foreign
DISVX	Foreign
MRICX	Foreign
TWWDX	Foreign
JAOSX	Foreign
HAINX	Foreign
FISMX	Foreign
DICVX	Foreign
NITRX	Foreign
GIGRX	Foreign
MIDCX	Foreign
SBICX	Foreign
CWVCX	Foreign
DIIEX	Foreign
MGRCX	Foreign
HAIGX	Foreign
SNGRX	Foreign
MIOFX	Foreign
FGFCX	Foreign
SWOIX	Foreign
LINCX	Foreign
JFEBX	Foreign
OAKIX	Foreign
GMO	Foreign
GMFRX	Foreign
BRECX	Foreign
PISRX	Foreign
ISCCX	Foreign
MMIAX	Foreign
FCFSX	Foreign
OIGCX	Foreign
EXWAX	Foreign
WAIGX	Foreign
TIERX	Foreign
DRIDX	Foreign
OAKEX	Foreign
LLINX	Foreign
PUVCX	Foreign
ARTJX	Foreign
TVIVX	Foreign
USCGX	GlobalAvgRisk
PRGSX	GlobalAvgRisk
JAWGX	GlobalAvgRisk
FEUCX	GlobalAvgRisk
JAWWX	GlobalAvgRisk
TWEBX	GlobalAvgRisk
JORNX	GlobalAvgRisk
CWGCX	GlobalAvgRisk
AGAAX	GlobalAvgRisk
WWNPX	GlobalAvgRisk
TEDSX	GlobalAvgRisk
JGVAX	GlobalAvgRisk
VHGEX	GlobalAvgRisk
TAVFX	GlobalAvgRisk
PGRCX	GlobalAvgRisk
TWGGX	GlobalAvgRisk
MGFNX	GlobalAvgRisk
OGLCX	GlobalAvgRisk
NPFCX	GlobalAvgRisk
ATECX	GlobalAvgRisk
ABCGX	GlobalAvgRisk
DABCX	GlobalAvgRisk
PUGCX	GlobalAvgRisk
PGVFX	GlobalAvgRisk
CSRCX	GlobalAvgRisk
USAWX	GlobalAvgRisk
MCAGX	GlobalAvgRisk
FWWFX	GlobalAvgRisk
MWECX	GlobalAvgRisk
TEMQX	GlobalAvgRisk
DBICX	GlobalAvgRisk
TEWTX	GlobalAvgRisk
TEGPX	GlobalAvgRisk
TEGTX	GlobalAvgRisk
OAKGX	GlobalAvgRisk
MWOCX	GlobalAvgRisk
MCGCX	GlobalAvgRisk
SCWCX	GlobalAvgRisk
WGRNX	GlobalAvgRisk
WAGTX	GlobalAvgRisk
EKGCX	GlobalAvgRisk
TESGX	GlobalAvgRisk
KGDCX	GlobalAvgRisk
OGICX	GlobalAvgRisk
MAPTX	FgnRgnlAbvAvgRisk
PRASX	FgnRgnlAbvAvgRisk
FSEAX	FgnRgnlAbvAvgRisk
SASPX	FgnRgnlAbvAvgRisk
FICDX	FgnRgnlAbvAvgRisk
MPACX	FgnRgnlAbvAvgRisk
FHKCX	FgnRgnlAbvAvgRisk
OBCHX	FgnRgnlAbvAvgRisk
FPBFX	FgnRgnlAbvAvgRisk
MACSX	FgnRgnlAbvAvgRisk
TCWCX	FgnRgnlAbvAvgRisk
FNORX	FgnRgnlAbvAvgRisk
VPACX	FgnRgnlAbvAvgRisk
PRJPX	FgnRgnlAbvAvgRisk
FJSCX	FgnRgnlAbvAvgRisk
TEURX	FgnRgnlAbvAvgRisk
USCOX	FgnRgnlAbvAvgRisk
FJPNX	FgnRgnlAbvAvgRisk
VEURX	FgnRgnlAbvAvgRisk
PRLAX	FgnRgnlAbvAvgRisk
FLATX	FgnRgnlAbvAvgRisk
FIEUX	FgnRgnlAbvAvgRisk
PRESX	FgnRgnlAbvAvgRisk
VEEEX	FgnRgnlAbvAvgRisk
MCEFX	FgnRgnlAbvAvgRisk
LETRX	FgnRgnlAbvAvgRisk
ADRE	DivEmgMktHighRisk
GEMCX	DivEmgMktHighRisk
VWO	DivEmgMktHighRisk
DCPEX	DivEmgMktHighRisk
AAEPX	DivEmgMktHighRisk
VEIEX	DivEmgMktHighRisk
EMRCX	DivEmgMktHighRisk
PRMSX	DivEmgMktHighRisk
AEMGX	DivEmgMktHighRisk
DEMCX	DivEmgMktHighRisk
TWMIX	DivEmgMktHighRisk
FEMKX	DivEmgMktHighRisk
REMGX	DivEmgMktHighRisk
ODVCX	DivEmgMktHighRisk
DFEMX	DivEmgMktHighRisk
QFFOX	DivEmgMktHighRisk
PEPSX	DivEmgMktHighRisk
EEM	DivEmgMktHighRisk
MMKBX	DivEmgMktHighRisk
DFEVX	DivEmgMktHighRisk
LZOEX	DivEmgMktHighRisk
BKF	DivEmgMktHighRisk
EEB	DivEmgMktHighRisk
DREGX	DivEmgMktHighRisk
LMEMX	DivEmgMktHighRisk
USEMX	DivEmgMktHighRisk
SSEMX	DivEmgMktHighRisk
SEKCX	DivEmgMktHighRisk
TEEMX	DivEmgMktHighRisk
GTDCX	DivEmgMktHighRisk
NEWCX	DivEmgMktHighRisk
SDMGX	DivEmgMktHighRisk
PCEFX	DivEmgMktHighRisk
FEMEX	DivEmgMktHighRisk
TDMTX	DivEmgMktHighRisk
MEMCX	DivEmgMktHighRisk
EUROX	DivEmgMktHighRisk
TREMX	DivEmgMktHighRisk
GLD	PrcMetVeryHighRisk
VGPMX	PrcMetVeryHighRisk
TGLDX	PrcMetVeryHighRisk
IGDCX	PrcMetVeryHighRisk
GOLDX	PrcMetVeryHighRisk
USAGX	PrcMetVeryHighRisk
FSAGX	PrcMetVeryHighRisk
EKWCX	PrcMetVeryHighRisk
BGEIX	PrcMetVeryHighRisk
FRGOX	PrcMetVeryHighRisk
RYPMX	PrcMetVeryHighRisk
USERX	PrcMetVeryHighRisk
SGDCX	PrcMetVeryHighRisk
UNWPX	PrcMetVeryHighRisk
OGMCX	PrcMetVeryHighRisk
MIDSX	PrcMetVeryHighRisk
STMDX	RealEstateHighRisk
MSUSX	RealEstateHighRisk
CGMRX	RealEstateHighRisk
FRESX	RealEstateHighRisk
AIGYX	RealEstateHighRisk
SSREX	RealEstateHighRisk
TRREX	RealEstateHighRisk
REACX	RealEstateHighRisk
CSCIX	RealEstateHighRisk
IARCX	RealEstateHighRisk
REIT	RealEstateHighRisk
VNQ	RealEstateHighRisk
CSRSX	RealEstateHighRisk
TCREX	RealEstateHighRisk
DFREX	RealEstateHighRisk
VGSIX	RealEstateHighRisk
PRCEX	RealEstateHighRisk
ORECX	RealEstateHighRisk
NBRFX	RealEstateHighRisk
RRRCX	RealEstateHighRisk
IRSCX	RealEstateHighRisk
DRECX	RealEstateHighRisk
TAREX	RealEstateHighRisk
FRRSX	RealEstateHighRisk
DPRCX	RealEstateHighRisk
PHRCX	RealEstateHighRisk
PCREX	RealEstateHighRisk
FRIFX	RealEstateHighRisk
CREBX	RealEstateHighRisk
RRESX	RealEstateHighRisk
ARECX	RealEstateHighRisk
FIREX	RealEstateHighRisk
EUEYX	RealEstateHighRisk
EGLRX	RealEstateHighRisk
FSCHX	E&NRHighRisk
VAW	E&NRHighRisk
FSDPX	E&NRHighRisk
FSNGX	E&NRHighRisk
PRNEX	E&NRHighRisk
DWA	E&NRHighRisk
PXI	E&NRHighRisk
IEO	E&NRHighRisk
VDE	E&NRHighRisk
RYBIX	E&NRHighRisk
IGE	E&NRHighRisk
GAGEX	E&NRHighRisk
FSENX	E&NRHighRisk
IGNCX	E&NRHighRisk
VGENX	E&NRHighRisk
DLDCX	E&NRHighRisk
IEFCX	E&NRHighRisk
RYEIX	E&NRHighRisk
FNARX	E&NRHighRisk
FSESX	E&NRHighRisk
PXE	E&NRHighRisk
GHACX	E&NRHighRisk
ICON	E&NRHighRisk
ICENX	E&NRHighRisk
PNRCX	E&NRHighRisk
XOP	E&NRHighRisk
GAAEX	E&NRHighRisk
JNRAX	E&NRHighRisk
PSPFX	E&NRHighRisk
RSNRX	E&NRHighRisk
PRGTX	TechHighRisk
FSELX	TechHighRisk
SCICX	TechHighRisk
VGT	TechHighRisk
MATFX	TechHighRisk
PRSCX	TechHighRisk
USSCX	TechHighRisk
DRGTX	TechHighRisk
WFTCX	TechHighRisk
FDCPX	TechHighRisk
FSPTX	TechHighRisk
ROGSX	TechHighRisk
FTHCX	TechHighRisk
MTCCX	TechHighRisk
ITHCX	TechHighRisk
FSDCX	TechHighRisk
JAGTX	TechHighRisk
FSCSX	TechHighRisk
KTCCX	TechHighRisk
DTGCX	TechHighRisk
WSTCX	TechHighRisk
JAMFX	TechHighRisk
WCSTX	TechHighRisk
RSIFX	TechHighRisk
FBSOX	TechHighRisk
BFOCX	TechHighRisk
BIPIX	OtherHighRisk
SMPIX	OtherHighRisk
TEPIX	OtherHighRisk
HCPIX	OtherHighRisk
FSPHX	OtherHighRisk
JAGLX	OtherHighRisk
PHPIX	OtherHighRisk
PCHSX	OtherHighRisk
RCGHX	OtherHighRisk
PRHSX	OtherHighRisk
FPHAX	OtherHighRisk
FBDIX	OtherHighRisk
VGHCX	OtherHighRisk
ECHSX	OtherHighRisk
SHSCX	OtherHighRisk
WIREX	OtherHighRisk
FSRFX	OtherHighRisk
FBIOX	OtherHighRisk
VHT	OtherHighRisk
RYOIX	OtherHighRisk
GTHCX	OtherHighRisk
FSHCX	OtherHighRisk
PCUFX	OtherHighRisk
FSAIX	OtherHighRisk
TCPIX	OtherHighRisk
GASFX	OtherHighRisk
BMPIX	OtherHighRisk
FNPIX	OtherHighRisk
BKPIX	OtherHighRisk
CYPIX	OtherHighRisk
FSMEX	OtherHighRisk
XLP	OtherHighRisk
FDFAX	OtherHighRisk
RYPIX	OtherHighRisk
MEDRX	OtherHighRisk
VDC	OtherHighRisk
INPIX	OtherHighRisk
CNPIX	OtherHighRisk
FIUIX	OtherHighRisk
TMFSX	OtherHighRisk
DFFCX	OtherHighRisk
FIDSX	OtherHighRisk
FSLBX	OtherHighRisk
FSUTX	OtherHighRisk
ICLEX	OtherHighRisk
VFH	OtherHighRisk
RYCIX	OtherHighRisk
PRMTX	OtherHighRisk
FLRUX	OtherHighRisk
FSPCX	OtherHighRisk
REPIX	OtherHighRisk
UTPIX	OtherHighRisk
FBMPX	OtherHighRisk
MMUCX	OtherHighRisk
FSRPX	OtherHighRisk
PRISX	OtherHighRisk
VOX	OtherHighRisk
BULIX	OtherHighRisk
VPU	OtherHighRisk
FSHOX	OtherHighRisk
VIS	OtherHighRisk
VCR	OtherHighRisk
FDLSX	OtherHighRisk
KMKNX	OtherHighRisk
FWRLX	OtherHighRisk
FSRBX	OtherHighRisk
ICTUX	OtherHighRisk
FSTCX	OtherHighRisk
FSCPX	OtherHighRisk
RYRIX	OtherHighRisk
FSVLX	OtherHighRisk
ICTRX	OtherHighRisk
ICFSX	OtherHighRisk
FSDAX	OtherHighRisk
ENPIX	OtherHighRisk
GABUX	OtherHighRisk
FCYIX	OtherHighRisk
ICCCX	OtherHighRisk
GABTX	OtherHighRisk
FSCGX	OtherHighRisk
FSLEX	OtherHighRisk
FSAVX	OtherHighRisk
WCPIX	OtherHighRisk
PMPIX	OtherHighRisk
JSVAX	OtherHighRisk
BEARX	BearHighRisk
CPCCX	BearHighRisk
URPIX	BearHighRisk
RTN	PersonalStock
GD	PersonalStock
^GSPC	PersonalStock
SPY	DaddySpecial
EFA	DaddySpecial
VNQ	DaddySpecial
BLV	DaddySpecial
SHY	DaddySpecial
GLD	DaddySpecial
SSETX	SmallCapGrowth
JAGLX	HealthLargeGrowth
LEVOX	LargeCapBlend